---^^^^------^^-
@---^---^---^---
----------^-----
^-^^-^^--^^^^-^^
.-----^----.----
------^---------
------^-.--^----
---^----&-----^
----------------
^^-^^^----^^^---
-------------^^-
------^---------
^------.^^------
-------^^-------
---.---------.--
.-----^^---.&---